31x31
3333300001003331333101013331333
1111311111113131313101013131313
3333300133333131313100013131313
3101010131111131313101113131313
3101010130000133313133333131313
3111111131111111113131111131313
3333333131333100003133333133313
1111113131313111113111113111113
0100333131313101013133333101013
0111311131313101013131111101013
3333300131313101013331000000013
3111110131313101011101110111113
3333310133313333310000010000013
1111311111111111311111111101113
3333313333313333300000010133313
3111013101313111111111110131313
3331013101333000010033333331313
0131113111110111110131010111313
0133313330010100010131010001313
1111311131011101011131111111313
0000333331000001010033333001333
1111011111111101111101013111111
0001000000000000010101013333333
0111111101010111110101111111113
0000010101010100000101333331333
1111010111111101110101310131311
0100010000010101010001310133300
0111010111110111011101310111111
0100010000000000000001310133300
0101010111011111011111311131311
0001000001000100000001333331332
http://jimblackler.net/blog/wp-content/uploads/2012/01/Screen-shot-2012-01-04-at-6.33.38-PM.png