15x15
300001000000000
311111011111110
310000013331000
310111113131011
310101003131012
310101013131113
300100013133333
311101113111010
333100013100010
113111013111111
333100013333333
311111111111013
333331333331013
111131311131113
000033310033333
http://news.povray.org/povray.binaries.images/attachment/%3Cweb.4f36a9c2be81e7d194d713cc0@news.povray.org%3E/maze_test_samples.jpg