16x16
0000000000000000
0110000000000000
0110000000000000
0000000001110000
0000000001110000
0000000001110000
0000000000000000
0000000000000000
0000000000000000
0000000000000000
0011000000000000
0011000000000000
0011000000000000
0011111000000000
0000000000000000
0000000000000000