15x15
333001333333333
013111311111113
013331310000012
011131311111011
013331333331000
013101111131110
013100010133333
013111010111113
013331000000013
011131111101113
010133333101333
010111113111311
010133333133310
010131111131110
000133333330000
https://arcadekomodo.com/home/wp-content/uploads/2013/10/DFSMaze.png