16x16
3333333333333333
0101111111111113
0100000010033313
0111100010131313
0100101010131313
0100001010131333
0101111111131111
0100000000133333
0111010100111113
0100010010001013
0101110111013333
0101010101013111
0101010101013333
0100010000001013
0111111111111113
0000000000000012