15x15
000001000000000
010111011111110
010001010000012
011101011111011
010001000001000
010101111101110
010100010100000
010111010111110
010001000000010
011101111101110
010100000101000
010111110111011
010100000100010
010101111101110
000100000000000