16x16
0000000000000000
0011100000000000
0010000000000000
0010000001110000
0000000001110000
0000000001110000
0000000000000000
0000000000000000
0000000000111000
0000000000110000
0011000000000000
0011000000000000
0011000000000000
0011111000000000
0000000000000000
0000000000000002